1111111111111111111
10000000000000000E1
100P000000C000000C1
1111111111111111111